{
  
  "areaId": 2,
  "Width": 10,
  "Height": 10,
  "StackToPass": 15,
  "BridgeDirect": [1, 0],
  "StartPosition": [5, 0],
  "EndPosition": [0, 6],
  "Grid": [
    [0, 0, 0, 0, 0, 0, 6, 0, 0, 0],
    [0, 0, 0, 0, 0, 0, 1, 0, 0, 0],
    [0, 0, 0, 0, 0, 0, 1, 0, 0, 0],
    [0, 0, 0, 1, 1, 1, 1, 0, 0, 0],
    [0, 0, 0, 1, 0, 0, 1, 0, 0, 0],
    [5, 1, 1, 1, 0, 0, 1, 0, 0, 0],
    [0, 0, 1, 0, 0, 0, 1, 0, 0, 0],
    [0, 0, 1, 1, 1, 1, 1, 0, 0, 0],
    [0, 0, 0, 0, 0, 0, 0, 0, 0, 0],
    [0, 0, 0, 0, 0, 0, 0, 0, 0, 0]
  ]
}