{
  
  "area": 1,
  "Width": 10,
  "Height": 10,
  "TotalStack": 10,
  "Grid": [
    [0, 0, 0, 0, 0, 0, 0, 0, 0, 0],
    [0, 0, 2, 1, 1, 7, 0, 0, 0, 0],
    [0, 0, 1, 0, 0, 1, 0, 0, 0, 0],
    [5, 1, 1, 7, 0, 1, 0, 0, 0, 0],
    [0, 0, 1, 1, 0, 1, 0, 0, 0, 0],
    [0, 0, 1, 1, 0, 1, 0, 2, 1, 6],
    [0, 0, 1, 1, 1, 1, 0, 1, 0, 0],
    [0, 0, 8, 1, 1, 1, 1, 9, 0, 0],
    [0, 0, 0, 0, 0, 0, 0, 0, 0, 0],
    [0, 0, 0, 0, 0, 0, 0, 0, 0, 0]
  ]
}